##########
#      S# #
# ##### ## #
# #   #####
#   ###   #
### # #   #
#   # #   #
# #     ###
#T## #    #
##########
