##########
#   S   # #
# ### # ## #
# #   #####
#   ###   #
### # #   #
#   # #   #
# #     ###
# ## #   T#
##########
